Amazon	NNP
Babel	NNP
ECMAScript	NNP
Google	NNP
JavaScript	NNP
Linux	NNP
MySQL	NNP
PHP	NNP
Parcel	NNP
Python	NNP
REST	NNP
Webpack NNP
딕셔너리	NNG
서비스 인	NNG
에포크	NNG
제페토	NNP
카테고리 NNG
코랩	NNP
태스크	NNG
파라미터	NNG
파이토치	NNP
git	NNG
