가드닝	생활 원예
가드레일	보호 난간
가든파티	연회, 마당 연회, 뜰 잔치
가스 마스크	방독면
가십거리	입방아거리
가이드 팁	안내원 봉사료, 여행 안내원 봉사료
가죽 패치	가죽 조각
갈라 쇼	뒤풀이 공연
개런티	출연료, 보증
갤러리 북	전시물 안내서, 전시물 안내책
갭 투자	시세 차익 투자
거버넌스	민관 협력, 협치, 행정
게놈	유전체
게이미피케이션	게임화
게이지	계기, 측정기, 성능
게이트 키퍼	생명 지킴이, 자살 방지 도우미
게이트웨이	관문
게임 체인저	국면 전환자, 국면 전환 요소
게임 퍼블리셔	배급사, 게임 배급사
게임메이커	주도 선수, 핵심 인물
경제 라인	경제 책임진
경제 벨트	경제 지대, 경제 띠
골 게터	주득점 선수, 골잡이
골드러시	① 노다지 열풍 ② 금메달 행진, 금메달 바람
골든 블록	금싸라기 동네
골든 시드	황금 종자, 우량 종자 산업
골든 위크	황금 주간
골든 크로스	강세 전환 지표
골든트라이앵글	① 마약 대량 재배지 ② 삼각 거점
공유 오피스	공유 사무실
관광 벨트	관광지, 관광 지대
구리스	윤활유
구호 키트	구호 도구, 구호 도구 모음, 구호 도구 꾸러미, 구호 상자
국제 옵서버	원양 어선 감시 관찰자
굿 다운로더	합법 내려받기
굿바이 히트	끝내기, 끝내기 안타
굿즈	팬 상품
규제 샌드박스	규제 유예, 규제 유예 제도
규제 프리 존	규제 완화 지역, 규제 대폭 완화 지역, 규제 자유 구역, 규제 청정 지역, 무규제 지역
그라운드 제로	대재앙 현장, 911테러 현장
그랜드 딜	통큰 협상, 대규모 협상, 대타협
그랜드 바겐	일괄 타결, 대타협
그랜드 세일	대규모 할인
그랜드 슬램	① 4대 주요 대회 우승, 4대 대회 석권, 세계 4대 대회 석권 ② 만루 홈런
그랜드 플랜	큰 계획, 대규모 계획
그러데이션	바림, 농담법
그레이존	회색 지대, 불투명 지역
그로테스크	기괴한, 터무니없는
그룹 멘토	집단 지도
그룹 투어	단체 관광
그룹웨어	공동 작업 전산망, 기업 전산망
그룹홈	자활 꿈터, 공동생활 가정
그리드	격자, 망
그리드 컴퓨팅	컴퓨터 연계 활용
그린 ICT	친환경 정보 통신 기술
그린 네트워크	생태 보존 구역, 녹지 연결망, 초록 띠
그린 라이트	긍정 신호, 초록불
그린 레시피	친환경 조리법
그린 루프	옥상 정원
그린 리모델링	친환경 새 단장
그린 바이오	친환경 생명 공학
그린 빌리지	친환경 마을
그린 시티	친환경 도시
그린 오션	친환경 시장, 친환경 산업, 친환경 전략
그린 인프라	친환경 기반 시설, 녹색 기반 시설
그린 카	친환경 차
그린 캠퍼스	친환경 대학, 녹색 교정
그린 파킹	친환경 주차 정책
그린 푸드 존	어린이 식품 안전 구역
그린슈머	친환경 소비자
그립	손잡이, 손잡이 쥐기, 손잡이 쥐기법
글램핑	고급 야영, 고급 캠핑
글로벌 네트워크	국제 협력망
글로벌 리더	세계적 지도자, 국제적 지도자
글로벌 몰	세계적 쇼핑몰
글로벌 스탠더드	국제 표준, 국제 기준
글로벌 캠퍼스	국제 대학
글로벌 트렌드	세계적 흐름
글로벌 파트너십	국제 동반 관계, 국제적 동반 관계
글로벌 펀드	국외 증권 포함 기금
글로벌 핀테크	국제 금융 기술
글로벌 허브	국제 중심, 세계 중심
글로벌리즘	세계 통합주의, 세계화주의
글로컬라이제이션	세방화(세계화+지방화), 세방화, 세계화지방화
나노 테크	나노 기술
나노 팹	나노 기술 핵심 연구 시설
나이트 게임	야간 경기
난민 포비아	난민 공포증
난코스	험한 길
내러티브	줄거리, 서사, 서사물, 서사체
내셔널 트러스트	국민 신탁
내추럴 컬러	자연색
내추럴 톤	자연색, 자연 색조
내추럴리즘	자연주의
넘버 플레이트	번호판
넘버링	번호 붙이기, 번호 매기기, 번호기
넘버원 브랜드	으뜸 상표
넘버원 파트너	으뜸 협력사, 으뜸 협력자
넛지	주의 환기, 부드러운 권유
네거티브	부정적인, 소극적인, 흠집 내기
네거티브 규제	최소 규제, 사후 규제, 우선 허용 사후 규제
네거티브 존	사후 규제 구역
네고	협상, 가격 협상
네오클래시시즘	신고전주의
네오클래식	신고전적
네오파시즘	신파시즘
네이미스트	작명가, 이름 설계사
네이밍	작명가, 이름 설계사
네임 밸류	이름값, 지명도
네트워킹	관계망, 연결망, 연계망, 교류
네트워킹 데이	만남의 날, 교류의 날
네티켓	누리꾼 예절
노 개런티	무보수, 무료
노 리턴	① 무수익 ② 반품 불가
노 옵션	선택 없는, 선택 관광 없는, 무선택
노 카운트	무효
노딜	합의 없는, 결렬, 합의 결렬
노르딕	북유럽, 북유럽형
노마드	유목민
노미네이트	후보 지명
노믹스	경제 정책
노블레스 오블리주	지도층 의무, 지도층 의무 실천
노쇼	예약 부도
노스모킹	금연
노스탤지어	향수, 향수병
노이즈	잡음, 소음
노이즈 마케팅	구설 홍보, 구설수 홍보
노이즈 스크린	소음 방지막
노키즈존	어린이 제한, 어린이 제한 공간
노파킹	주차 금지
녹아웃	① 승자 진출, 승자 진출 경기 ② 투수 강판
논픽션	실화
뉴 노멀	새 기준, 새 일상
뉴 미디어	새로운 매체, 새 매체, 신매체
뉴 트렌드	새 흐름, 새 유행, 신경향, 최신 경향
뉴 페이스	새 인물
뉴트로	신복고, 새 복고
니즈	수요, 바람
니트족	일할 의사 없는 청년 무직자, 무기력 청년 무직자
님비	지역 이기주의
다우너 소	주저앉는 소
다운 사이클	하강 국면, 하락 추세
다운 스트림	아래 흐름, 아랫단계 흐름
다운 턴	하락 곡점
다운로딩	받기, 내려받기
다운사이징	감축, 축소, 줄이기
다운타운	중심가, 번화가
다이내믹	역동적, 동적
다이얼로그	대화, 토론, 토론 행사
다크 모드	어두운 화면
다크 컬러	어두운 색
다크 투어	역사 교훈 여행
다크 패턴	눈속임 설계
닥터 쇼핑	병원 순례
닥터헬기	응급 헬기
답사 코스	답사 경로, 답사 길
대남 라인	대남 책임진
대북 이슈	대북 현안
대시보드	계기판, 상황판
더블 룸	2인 침대방
더블 캐스팅	이중 배역, 2인 1역
더블딥	이중 침체
데드 크로스	인구 자연 감소, 약세 전환 지표, 주가 거래량 하락
데드라인	마감, 기한, 한계선
데모데이	시연회
데스 노트	부적격자 명단
데이케어	주간 보호
데이터 로밍	국외 인터넷 연결
데이터 바우처	자료 이용권, 데이터 이용권
데이터 뱅크	자료 은행
데이트레이딩	단타 매매, 초단타 매매
데일리 메뉴	나날 차림표, 오늘의 식단, 오늘의 차림표, 일일 식단
데일리 웨어	평상복
데자뷔	기시감, 이미 본 느낌
데칼코마니	대칭복사
데탕트	긴장 완화
델타	삼각주
도그마	교조, 교리, 독단적 신념
도슨트	해설사, 전시물 해설사, 전문 안내원
도슨트 북	전문 안내서, 전시 안내서
도어맨	안내인, 현관 안내인
도킹	연결, 결합
도핑	① 약물 사용, 약물 복용 ② 첨가, 불순물 첨가
돔 하우스	둥근 지붕 집
듀레이션	평균 자금 회수 기간, 평균 자금 상환 기간
듀얼	이중
듀얼 컨버터	이중 변환기, 이중 역병렬 변환기
드라이 에이징	건식 숙성
드라이버 라이선스	운전면허, 운전면허증
드라이브 정책	주도 정책, 강공 정책
드라이브스루	승차, 차량 이동형
드라이플라워	말린 꽃
드래그	끌기
드레스 코드	옷차림 규칙, 옷차림 약속, 의상 규칙
드리프트 앵글	활주각
드리핑	흘림법, 흘림 그림
드림 팀	환상팀
드립 커피	내림 커피
디도스 공격	분산 서비스 거부 공격, 동시 접속 서버 마비 공격, 서버 마비 공격
디바이스	기기, 장치
디버거	오류 수정자
디버그	오류 수정
디버깅	오류 수정
디베이트	토론, 논쟁 토론, 찬반 토론
디벨로퍼	개발업자, 부동산 개발업자
디브레인	디지털 예산 회계 시스템
디브리핑	결과 보고, 질문 조사, 임무 보고
디비전	부, 부문, 구획
디스토피아	역유토피아
디스펜서	공급기, 정량 공급기
디엠	① 우편 광고, 우편 광고물 ② 쪽지
디오더런트	체취 제거제
디자인 허브	디자인 거점
디지털 노마드족	디지털 유목민
디지털 사이니지	디지털 맞춤형 광고, 전자 광고판
디지털 시그니처	전자 서명
디지털 트윈	디지털 복제, 디지털 복제물
디지털 퍼스트	디지털 우선
디지털 포렌식	디지털 증거 수집, 디지털 자료 복원, 디지털 과학 수사, 전자 법의학, 전자 법의학 수사
디텍터	탐지기, 검출기
디톡스	디지털 거리 두기
디펜스	방어, 수비
디폴트	① 채무 불이행 ② 기본값
디폴트 옵션	사전 지정 운용 제도, 자동 투자 제도
디퓨저	방향기
디플레이션	물가 하락세, 물가 하락 현상
디플로마	수료증, 졸업장, 학위 증명서
딜레마	궁지, 진퇴양난
딜레이	늦춤, 지연, 연기
딜리버리	배달
딜리버리 로봇	배달 로봇
딥 러닝	심층 기계 학습, 심화 학습
딥 체인지	근본적 변화
딥 테크	기저 기술, 원천 기술
딥 페이크	이미지 합성 기술, 가짜 영상
딩크족	자녀 없는 맞벌이 부부, 무자녀 맞벌이 부부
라스트 신	마지막 장면
라운드	운동장, 경기장, 야구장, 구장
라운지	맞이방, 휴게실
라이닝	안감
라이더	배달원, 운전자, 타는 이
라이딩	타기
라이브러리	자료관, 도서관
라이선스	운전면허, 운전면허증
라이트	긍정 신호, 초록불
라이트 블루	하늘색
라이프 가드	안전 요원
라이프 사이클	생애 주기, 수명 주기, 생명 주기
라이프 케어	건강 돌봄, 생활 관리
라이프 태그	생명 팔찌
라이프 플래너	생활 설계사, 보험 모집인
라이플	말린 꽃
라인업	선수 명단, 출연진 명단, 출연진, 진용, 순번, 제품군
랑데부	만남
래프팅	급류 타기, 물살 타기
래핑 광고	도배 광고
랜	통큰 협상, 대규모 협상, 대타협
랜덤 박스	무작위 상품
랜덤 샘플링	무작위 표본, 임의 표본
랜덤 채팅	무작위 채팅
랜딩	착지
랜섬웨어	금품 요구 악성 프로그램
랜턴	손전등
랠리	① 주가 강세 전환 ② 주고받기 ③ 자동차 경주
랠리 포인트 시스템	직접 득점제
랭크	순위, (등급, 순위를) 차지하다, (등급, 순위를) 매기다.
러닝 개런티	흥행 보수
러닝 팩토리	실습장
러닝메이트	동반자, 동반 입후보자
러시아워	몰릴 때, 붐빌 때, 혼잡 시간
러프 지역	잡초 지역, 부정적 구역
럭셔리 카	고가차
런 아웃	중심축 이탈
런치 파티	점심 모임, 점심 자리
레거시	유산, 대회 유산
레귤러	보통, 평범한, 일반적인
레드 라인	허용 한계선
레드 오션	포화 시장
레드 존	위험 구역, 금지 구역, 청소년 제한 구역
레버리지 효과	지렛대 효과, 자기 자본 대비 총자산 한도
레어	드문, 희귀한, 살짝 익힌
레어템	희귀품
레이블	데이터 주석자
레이블링	데이터 주석
레이아웃	배열, 배치, 판매김
레이어드 룩	겹쳐 입기 차림, 겹쳐 입기풍
레인코트	비옷
레일 바이크	철길 자전거, 궤도 자전거
레임덕	지도력 공백, 권력 누수
레저 타운	휴양지
레저웨어	여가복, 여가 옷
레지던스	거주지, 창작공간, 창작촌, 생활형 숙박시설
레지던시	거주지, 창작공간, 창작촌, 생활형 숙박시설
레지던트	전공의
레지스탕스	저항
레지스터	저항기, 기록기
레짐	체제
레토르트 식품	고압 가열 살균 식품
레트로	복고풍
레퍼리	심판, 심사 위원
레퍼토리	곡목, 연주 곡목, 노래 곡목, 상연 목록
레프트 윙	왼쪽 공격수, 왼쪽 날개
레플리카	복제, 복제품, 복사, 보급형 제품
렉처	강연, 강의
렌더링	3차원 구현, 완성 예상도
렌털 하우스	빌림집, 임대 주택
렌트 푸어	세입 빈곤층
로그 시트	운영 기록지
로그 파일	사용 기록
로그온	접속, 접속 중, 들어가기
로드 매니저	수행 매니저
로드 맵	이행안, 단계별 이행안, 일정 계획
로드 무비	여정 영화
로드 북	도로 안내서
로드 뷰	거리 보기, 거리 풍경, 거리 사진
로드 쇼	순회 설명회, 순회 행사, 순회 상영, 길거리 쇼, 거리 공연, 특별 공연, 특별 상영
로드 숍	가두 직영점
로드킬	동물 찻길 사고, 찻길 동물 사고, 동물 교통사고
로딩	받기, 내려받기
로밍 폰	국외용 휴대 전화
로보어드바이저	로봇 자산 관리사
로보틱스	로봇 공학
로비스트	막후교섭자
로스 컷	손절매
로스쿨	법학 전문 대학원, 법전, 법전원
로스팅	굽기, 볶기
로열박스	귀빈석
로직	논리
로진 백	송진, 송진 주머니
로커	사물함, 보관함, 개인 보관함
로컬	세방화(세계화+지방화), 세방화, 세계화지방화
로컬 시네마	지역 영화, 지역 독립 영화
로컬 푸드	지역 음식, 향토 음식, 지역 먹거리, 지역 먹을거리, 향토 먹을거리
로케이션	현지 촬영
로터리	회전형, 회전 교차로
로테이션	순환, 회전, 선회
로펌	법률 회사, 법률 사무소
로프	밧줄, 줄
로하스	친환경살이
론드리	세탁소, 세탁물, 세탁
론칭	사업 개시, 신규 사업 개시, 출시
롤 오버	만기 연장
루미나리에	불빛 축제, 불빛 잔치, 불빛 조명 시설
루저	실패자, 패배자
루키	신인, 신인 선수
루트	통로, 경로
루틴	일상, 반복적 일상, 반복 연산
루프 톱	옥상
룸 시어터	안방 극장
르포	현지 보고, 보고 기사, 현장 보고, 현장 보고서
리그	대전, 연맹, 연맹전, 시합장
리넨	마, 마직물
리노베이션	새 단장, 개보수
리뉴얼	새 단장, 재구성
리디노미네이션	화폐 단위 변경
리딩 브랜드	으뜸 상표, 주도 상표
리마인드	상기, 다시 떠올림
리마인드 웨딩	회상 결혼식
리모트 컨트롤	조정기, 원격 조정기
리미티드	한정
리미티드 에디션	한정품, 한정판
리바이벌	재연
리버서블	양면, 양면 사용, 양면으로 쓰는
리베이트	대가성 불법 사례금, 사례비, 뒷돈
리벤지	복수, 보복
리벤지 포르노	보복성 음란물, 해코지 음란물
리볼빙	회전 결제, 일부 결제 금액 이월 약정
리부트	되띄우기, 재가동
리뷰어	논평가, 검토자
리빌드	재구성
리빙 랩	생활 실험실, 살아 있는 실험실, 우리 마을 실험실
리빙 트립	살아보기 여행
리사이클링	재활용
리사이틀	연주회, 발표회
리서치 헤드	수석 연구원
리세션	경기 침체, 경기 후퇴
리셉션	① 연회, 피로연, 축하연, 초대연 ② 접수처
리소스	자원
리스 산업	임대업
리스백	매각 차용
리스케줄링	채무 상환 조정, 채무 재조정, 일정 조정
리스타트	다시 시작, 재시작
리스토어	복원
리스펙트	존경
리얼 버라이어티	생생 예능
리얼리즘	사실주의
리얼타임	실시간
리워드	보상, 보상금, 적립금
리코딩	녹음, 기록
리퀘스트	신청, 요청
리크루팅	채용, 인재 충원, 인재 등용, 채용 설명회
리터러시	문해력, 이해력, 글 이해력
리터칭	수정, 보정
리턴	① 무수익 ② 반품 불가
리턴 매치	복수전, 재대결
리테일	소매, 소매 금융
리테일 스토어	소매점
리테일러	소매업자, 소매업체
리퍼브	손질 상품
리페어	수리
리포팅	보도, 보고서
리프레시	재충전
리프레시 데이	재충전의 날
리프레시 휴직	재충전 휴직
리플	댓글
리플릿	광고지, 홍보지, 홍보물, 홍보 책자, 홍보 전단
리플족	댓글족, 답글족
린치	폭력
릴레이 골	연속 골
릴리스	출시, 배포
릴리프	구원, 부각, 부조
릴리프 피처	구원 투수, 교체 투수
링 커리어	경기 경력
링크 텍스트	연결 문서
링크스	바닷가 골프장
링클 프리	구김 방지
마그네틱 카드	자기 카드
마그네틱 테이프	자기 테이프
마도로스	선원
마리나	해안 유원지
마블링	결지방
마스터 클래스	명인 강좌
마스터플래너	으뜸 설계사, 책임 설계사, 총괄 계획가
마스터플랜	종합 계획, 기본 계획, 기본 설계
마에스트로	명장, 장인
마운틴 뷰	산 전망
마이너	비주류
마이너 캐릭터	주변 인물
마이너리티	소수 집단
마이데이터	개인 정보, 개인 맞춤형 정보
마이스	전시 복합 산업
마이스터	전문가
마이카	자가용, 자기 차, 내 차
마이크로 러닝	알토란 학습, 단기 속성 학습
마이크로 미디어	개인 매체
마이크로 브루어리	소규모 맥주 제조장, 소규모 맥주 공장
마이크로그리드	소규모 독립형 전력망
마이크로바이옴	인체 미생물 유전 정보
마인드맵	생각 그물
마일드	부드러운, 순한
마일스톤	이정표, 중요 단계
마임	무언극
마케터	판매 전문가
마케팅 리서치	시장 조사, 소비자 조사, 상품 조사
마켓 셰어	시장 점유, 시장 점유율
마켓 테스트	시범 판매
마켓 트렌드	시장 흐름
마켓 플레이스	시장, 장
마타도어	흑색 선전, 모략 선전
맞춤 코칭	맞춤 지도
매너리즘	타성
매니시	남성적
매니시 룩	남성풍
매니지드 서비스	위탁 관리 서비스
매니지먼트	관리, 연예 기획
매니페스토	공약, 공약 지키기, 참공약
매머드	큰, 대규모, 대형
매스 게임	집단 체조
매스 미디어	대중 매체
매스티지	대중 명품
매치	복수전, 재대결
매치 메이킹	상대 정하기
매치 포인트	끝내기 점수
매치업	맞대결, 대진, 일대일
매칭 데이	이음의 날, 연결의 날
매칭 비율	분담 비율
매칭 시스템	협력 체계, 연결 체계
매칭 펀드	대응 자금, 대응 기금
매크로	① 거시적 ② 자동 실행, 모듬 명령
머그 샷	피의자 사진, 피의자 사진 공개 제도
머니 게임	돈 놀이
머스트 해브	필수품
머신 랭귀지	기계어
머신 러닝	기계 학습
머천다이징	상품화
멀티 뷰	다중 화면
멀티 스폿	다면, 다중, 다각도
멀티 유즈	다용도
멀티 포지션	다중 역할
멀티 플랫폼	다중 운영 체제
멀티숍	두루가게, 잡화점
멀티태스킹	다중 작업
멀티플렉스	복합 상영관
메가	초대형
메가 FTA	다자간 자유 무역 협정
메가 뱅크	거대 은행, 초대형 은행
메가 시티	특화 도시, 거대 도시
메가 폴리스	거대 도시
메가 프로젝트	초대형 사업
메가톤급	핵폭탄급, 초대형
메가폰	확성기
메디 시티	의료 도시
메디컬	의료
메디컬 비자	의료 비자, 의료 사증
메르스	중동 호흡기 증후군
메리트	경쟁력, 가격 경쟁력, 경제 효과, 이익, 이점, 장점
메세나	문예 후원, 예술 후원
메신저 피싱	문자 금융 사기
메이데이	노동절
메이저	대형, 주류, 주요한
메이킹 필름	뒷 이야기, 제작 과정 영상
메인 캐릭터	주요 인물
메인스트림	주류
메카	중심, 중심지, 성지
메커니즘	구조, 체제, 작동 원리
메커트로닉스	전자 정보 기계
메타데이터	설명 자료, 설명 데이터, 해당 대상 설명 데이터
메타포	은유
메탈릭	금속성
멘토 데이	상담회
멘티	학생
멜로물	통속극
면접 클리닉	면접 지원, 면접 지원 프로그램
모기지 론	미국형 주택 담보 대출, 주택 담보 대출
모노레일	한 줄 철도, 단선 철도
모노톤	단색조, 무채색
모놀로그	혼잣말, 독백
모델링	친환경 새 단장
모델케이스	본보기
모듈	조립식, 부분
모듈러 주택	조립식 주택
모드	어두운 화면
모라토리엄	지급 유예, 지불 유예, 지불 유예 기간, 유예
모럴 해저드	도덕적 해이
모멘텀	전환 국면, 탄력
모멘트	계기, 동기
모바일 커머스	이동 통신 거래, 모바일 거래
모빌리티	전기 이동 수단
모션 캡처	동작 갈무리
모션 컨트롤	동작 제어, 동작 제어법
모토	신조, 좌우명, 목표
모티브	동기
모티켓	통신 예절
몸 캠	신체 불법 촬영, 불법 신체 촬영
몸 캠 피싱	신체 불법 촬영 협박, 불법 촬영 협박
무브먼트	움직임, 운동, 동력 장치
무비 트레일러	예고편
무빙워크	자동길
뮤지엄	박물관, 미술관
뮤지엄 콤플렉스	국립박물관 복합 단지, 박물관 단지
뮤직 아카데미	음악원, 음악 단체, 음악 학원, 음악 강좌
미니멀	최소의, 최소
미니멀 라이프	최소주의 생활, 단순한 생활 방식
미니멀 아트	최소 미술, 단순 미술
미니멀리즘	최소주의
미니멈 개런티	최소 보장 금액
미니아튀르	세밀화
미드필드	중간 지역
미들 파워	중재자, 중재 국가
미디어 데이	기자 간담회, 기자 환담회
미디어 리터러시	매체 이해력
미디어 믹스	여러 매체 활용 전략, 매체 활용 전략
미디어 스크램블	매체 혼합
미디어 커머스	매체 상거래
미스매치	부조화, 잘못 연결, 연결 오류
미스매칭	부조화, 잘못 연결, 연결 오류
미스터리 쇼퍼	비밀 평가원, 암행 평가원
미코노미	나를 위한 쇼핑, 나를 위한 소비
믹스견	혼종견
믹스트 존	공동 취재 구역
밀 키트	바로 요리 세트
밀레니얼	새천년, 새천년 세대
밀레니엄	천년, 새천년, 천년맞이
밀레니엄 베이비	천년둥이, 새천년둥이
밀리언 셀러	백만 부 판매, 대박 상품, 백만 판매
밀리터리 룩	군복 차림, 군복풍
밀리터리 배낭	군대 배낭
밀리터리 페스티벌	군사 과학 축제, 군사 축제
밋 업	설명회, 만남
밋 업 데이	설명회, 만남의 날
바로미터	잣대, 지표, 척도
바로크 스타일	바로크 양식
바우처	자료 이용권, 데이터 이용권
바운더리	경계, 구역, 범위, 담당 범위, 경계선
바이럴	입소문
바이백	되사기, 주식 되사기
바이시클	자전거
바이어	구매자, 수입상
바이오	친환경 생명 공학
바이오 메디컬	생명 의약, 생명 의학의
바이오 밸리	생명 공학 지구
바이오 클러스터	생명 공학 협력 단지
바이오 헬스	생명 건강, 생명 건강 산업
바이오매스	생물량, 생물 에너지원
바이오시밀러	동등 생물 의약품, 생명 의약품 복제약
바이오테크	생명 공학
바인더	보관철
바인딩	조임, 조임쇠, 부착기
박스 아웃	길 차단, 진로 방해
박스 오피스	① 흥행 수익 ② 매표소
발레파킹	대리 주차
발리슛	공중 차기
발리킥	공중 차기
방카쉬랑스	은행 연계 보험
배너	막대 광고, 띠 광고, 현수막, 현수막 광고
배리어 프리	무장애, 무장벽, 장애물 없는, 장벽 없는
백 데이터	근거 자료, 참고 자료, 보관 자료
백도어	보안 구멍
백업 파일	보관본 파일
밴사	결제 대행 업체, 신용 카드 결제망 사업자, 부가 가치 통신망 사업자
밸류 체인	가치 사슬, 공급망, 공급 체계
밸류에이션	평가 가치, 가치 평가
밸리	생명 공학 지구
밸리 효과	후유증, 올림픽 후유증
버드 스트라이크	조류 충돌 사고, 항공기 조류 충돌 사고
버스킹	거리 공연
버즈 마케팅	입소문 마케팅
버추얼	가상
버킷 리스트	소망 목록
번들링	묶음 판매, 끼워 팔기
번아웃 증후군	탈진 증후군
번인 현상	잔상 현상, 화면 잔상 현상
벌룬	풍선, 기구
벌크	무더기 짐, 미포장, 미포장 상품
베드타운	침상 도시, 비자족 도시
베이비 부머	베이비 붐 세대
베이비 시트	유아용 의자
베이비 페어	육아 용품 박람회
베이비 푸드	아기 음식, 아기 밥
베이비 플래너	육아 설계사
베이스	기본, 바탕
베타 버전	시험판
베팅 액	투자액, 판돈
벤더	연보라
벤처 캐피털	벤처 투자사, 벤처 기업 자본, 벤처 투자 자본
벤치 클리어링	몸싸움, 집단 몸싸움, 선수단 몸싸움
벤치마크	① 기준, 기준점 ② 본받기, 본 따르기
벤치마킹	① 비교 검토, 견주기 ② 본받기, 본 따르기 ③ 성능 시험
벤치워머	대기, 대기 선수, 후보 선수
벨보이	객실 안내, 객실 안내원
보디 카피	광고 문안
보디 케어	몸 가꾸기
보이시 룩	소년풍
보이콧	거절, 거부, 배척
보컬 마스터	노래 지도자
보컬리스트	가수
보틀넥	병목 현상
볼라드	안전 말뚝, 진입 방지 말뚝, 길 말뚝
볼런티어	자원봉사자
부비 트랩	위장 폭탄
부스	관, 공간
북 디자인	책 도안, 책 디자인
북 마스터	책 길잡이
북 섹션	책 소개 면, 책 소개란
북 코칭	독서 지도
북 콘서트	출판 기념회, 작가와의 만남
북 토크	책 이야기 마당, 출판 기념회, 작가와의 만남
북 페어	도서 박람회
북클럽	독서 모임
북텔러	책 낭독자
붐 업	활성화, 띄우기
뷰티 살롱	미용실
뷰티 엑스포	미용 국제 박람회
뷰파인더	보기 창
브라운 백 미팅	도시락 토론회, 도시락 모임, 도시락 회의
브랜드 파워	상표 경쟁력
브레인스토밍	난상 토론, 발상 모으기
브렉시트	영국 유럽연합 탈퇴
브로슈어	안내서, 소책자
브로커	중개인, 협잡꾼
브론즈	청동
브리지	다리, 연결, 탑승교
브리프	요약 보고, 요약서
브리핑 룸	기자 회견실
브이로그	영상 일기
브이패스	어선 위치 발신 장치
블라인드 테스트	정보 가림 평가
블라인드 트러스트	백지 위임, 백지 신탁, 백지 신탁제
블라인드 펀드	투자처 미특정 기금, 선모집 후투자 기금
블랙 먼데이	검은 월요일
블랙 아이스	살얼음, 도로 살얼음
블랙 컨슈머	악덕 소비자
블랙마켓	암시장
블랙아웃	대정전, 일시적 기억 상실
블렌딩	섞음
블록 세일	주식 일괄 매각
블록버스터	초대작, 초대형 영화
블루 오션	대안 시장, 뜨는 시장
블루 이코노미	청색 경제
블루 존	안전 지역, 청정 지역, 보호 구역
블루벨트	청정 수역, 수산 자원 보호 지역, 근해 보호 지역
블루진	청바지
블루칩	우량주, 대량 우량주
비건	순채, 엄격한 채식주의, 엄격한 채식주의자
비주얼 노블	소설형 게임, 그림 소설
비주얼 디스플레이	영상 표시
비주얼 마케팅	진열 판매, 외관 중심 판촉, 외관 중심 마케팅
비즈니스 모델	사업 모형
비콘	교통 정보 수집 장치, 근거리 무선 통신 장치
비하인드 컷	미공개 장면, 미공개 영상
빅 카드	관심거리, 주관심거리
빅 테크	거대 기술, 거대 정보 기술, 정보 통신 대기업
빅 텐트	초당파 연합, 포괄 정당
빅 픽처	큰 그림
빅딜	사업 맞교환, 대기업 간 교환
빅뱅	대폭발, 대변혁
빌리지	친환경 마을
빌트인	붙박이, 설치형
사드	외벽 영상
사모 펀드	소수 투자자 기금
사보타주	태업, 파괴 행위
사스	급성 호흡기 증후군
사이니지	디지털 맞춤형 광고, 전자 광고판
사이드카	주가 급락 경보, 호가 일시 정지
사이버 론	온라인 대출, 사이버 대출
사이버 멘토링	누리 상담, 온라인 상담
사이버 몰	가상 장터, 온라인 장터
사이버 인프라	전자 정보 공유 기반 시설
사이버불링	온라인 괴롭힘, 사이버 괴롭힘
사이보그	인조 인간
사이클링	재활용
사일로	저장탑, 저장 창고
샌드박스	규제 유예, 규제 유예 제도
샘플러	맛보기 묶음
섀도 캐비닛	그림자 내각
서든 데스	즉각 퇴출, 단판 승부
서머 타임	여름 알뜰 시간
서머리	간추림, 요약, 개요
서머스쿨	여름 학교
서밋	회담, 정상 회담
서스펜더	멜빵
서스펜션	연결부
서스펜스	긴장, 긴장감
서클	눈 그늘
서킷 브레이커	일시 매매 정지
서티피케이션	인증서, 검역 증명서
서포터스	후원자, 응원단, 홍보단, 체험단
선루프	지붕창
선베드	일광욕 의자
섬네일	영상 소개 화면, 마중 그림
세그먼트	분할, 칸살
세단	승용차
세미콜론	쌍반점
세미프로	준 프로
세션	경기 침체, 경기 후퇴
세이프가드	긴급 수입 제한, 긴급 수입 제한 조치
세이프티	안전
세컨더리 보이콧	제3자 제재
섹션	책 소개 면, 책 소개란
섹스어필	성적 매력
섹터	부문, 지구
센세이션	큰 화제, 선풍
셀러	무역인, 무역업자
셀러브리티	유명인, 명사
셀럽	유명인, 명사
셧다운	중단, 활동 정지, 일시 휴업
셧아웃	완봉, 공장 폐쇄
셰어 하우스	공유 주택
셰어런팅	자녀 공개
셰어링	공유, 자원 공유
셸터	피신처, 보호소, 대피소
소비 트렌드	소비 흐름, 소비 경향
소셜 네트워크 서비스	누리 소통망,  누리 소통망 서비스, 사회 관계망, 사회 관계망 서비스
소셜 디자이너	공동체 혁신 활동가, 공동체 활동가
소셜 믹스	어울 단지, 어울 단지 조성, 혼합 분양
소셜 벤처	사회적 벤처
소셜 채널	누리 소통망, 사회 관계망
소셜 커머스	온라인 상거래, 공동 할인 구매
소울푸드	위안 음식
소트	정렬
소퍼모어 징크스	후속작 증후군, 2년 차 증후군
소프트 랜딩	연착륙
소프트 파워	문화적 영향력, 부드러운 힘
솔라 시티	태양 에너지 도시, 햇살 도시
쇼룸	전시실, 진열실, 체험 전시실
쇼케이스	선보임 공연, 시범 전시
쇼트 리스트	최종 후보 명단
숍 마스터	매장 담당, 매장 담당자
숍 인 숍	어울가게
수출 셰어	수출 점유율
슈 메이커	신발 제작자
슈퍼 리치	거부, 초부호
슈퍼 사이클	장기 호황
슈퍼 체인	대형 연쇄점, 대형 잡화 연쇄점
슈퍼바이저	감독자, 관리자
스낵 컬처	자투리 문화
스냅	똑딱단추
스냅 사진	순간 사진
스마트 공장	지능형 공장
스마트 공항	지능형 공항
스마트 국방	지능형 국방
스마트 그리드	지능형 전력망
스마트 글라스	지능형 안경, 지능형 전광 유리
스마트 도시	지능형 도시
스마트 러닝 팩토리	지능형 실습 공장
스마트 머니	단기 이동성 자금
스마트 모빌리티	1인 전동차, 지능형 이동 수단
스마트 병원	지능형 병원
스마트 빌딩	지능형 건물
스마트 빌리지	지능형 마을
스마트 센서	지능형 감지기
스마트 스토어	지능형 가게
스마트 시티	지능형 도시
스마트 에너지	지능형 에너지
스마트 오피스	지능형 사무실
스마트 워크	원격 근무
스마트 인프라	지능형 기반, 지능형 기반 시설
스마트 팜	지능형 농장
스마트 팜 혁신 밸리	지능형 농장 혁신 단지
스마트 팩토리	지능형 공장
스마트 헬스케어	지능형 건강 관리
스마트 홈	지능형 가전 가구
스마트화	인공 지능화, 지능화
스모킹 건	결정적 증거
스몰 딜	부분 합의, 작은 협상
스몰 라이선스	소규모 인허가
스미싱	문자 사기, 문자 결제 사기
스와프	맞교환, 교환, 통화 맞교환, 국가 간 통화 맞교환
스와핑	맞교환, 교환, 통화 맞교환, 국가 간 통화 맞교환
스위치히터	양손 타자
스위칭	전환, 바꾸기
스윔슈트	수영복
스윙	휘두르기, 채 휘두르기, 팔젓기, 몸 비틀기
스카이 브리지	구름다리
스케일 업	규모 확장, 확장, 확대
스케줄러	일정표
스크랩북	자료 모음책
스크립터	촬영 기록자, 구성 작가
스키드 마크	타이어 자국, 타이어 밀린 자국
스킬	대인 관계 기술
스타덤	인기 대열
스타디움	경기장
스타트업	새싹 기업, 창업 초기 기업, 신생 기업
스타플레이어	인기 선수
스태그플레이션	불황 속 물가 상승
스탠더드	국제 표준, 국제 기준
스탠더드 넘버	대중 명곡
스탠드스틸	이동 제한, 현상 동결, 현상 동결 합의
스탠스	자세, 입장, 태도
스탬프 투어	도장 찍기 여행
스테디 트렌드	안정된 경향
스테디셀러	꾸준 상품
스토리 북	이야기책, 동화책
스토리라인	줄거리 선, 기본 줄거리
스토리보드	줄거리판, 이야기판
스토리지	저장 장치, 기억 장치, 저장소
스토리텔링	이야기하기
스톡옵션	주식 매수 선택권
스톱 모션	정지 동작, 정지 동작 촬영
스톱오버	경유지 체류
스튜어드십 코드	의결권 행사 지침
스트라이프	줄, 줄무늬
스트라이프 패턴	줄무늬
스트레이트 뉴스	단신, 직접 뉴스
스트롱 맨	권위적 지도자, 독재자
스트리밍	바로 재생, 실시간 재생
스트리트 패션	거리 패션
스트립	원금 이자 분리 채권, 연속 만기 도래 증권 발행
스트링	문자열, 끈
스티밍	열처리
스틸 컷	정지 화면, 사진
스팀 타월	찜질 수건, 김 수건
스파크	불꽃
스파클링	탄산
스팽글	반짝이
스퍼트	막판 힘내기, 끝판 힘내기, 역주, 전력 질주
스페셜 이펙트	특수 효과
스페셜리스트	전문가
스페셜티 스토어	전문점
스페이스	열린 제작실
스펙트럼	색깔, 층, 파장
스포일러	영화 헤살꾼, 줄거리 폭로자
스폿	다면, 다중, 다각도
스폿 뉴스	초점 뉴스, 반짝 뉴스
스폿 아이템	반짝 상품
스프린트 게임	단거리 경기, 스프린트 경기
스핀오프	회사 분할, 파생작
슬래브	바닥판, 평판
슬랙스	긴바지
슬러거	강타자
슬럼가	빈민가
슬로 시티	참살이 도시
슬로프	활주로, 스키 활주로
슬리브	소매
슬림핏	날씬태, 날씬맵시
슬림화	조직 감축, 감축, 축소
슬립 다운	미끄러져 넘어짐
시그니처	전자 서명
시그니처 아이템	대표 상품
시놉시스	줄거리, 개요
시드 머니	종잣돈, 투자 기금
시드 뱅크	종자 은행
시뮬레이터	모의실험 장치, 모의실험기
시스루	비침 옷
시스템 키친	일체형 부엌 가구, 일체형 주방 가구
시스템 트레이딩	자동 매매
시즈닝	양념
시즌 오프	계절 마감, 계절 할인
시티 라이프	도시 생활, 도시살이
시티 룩	도시풍
시티 뷰	도시 전망
식스 맨	우수 후보 선수, 여섯 번째 선수
신스틸러	명품 조연
실러버스	강의 계획, 강의 계획서
실버 비즈니스	경로 산업
실버 시터	어르신 도우미, 경로 도우미
실버 존	노인 보호 구역
심벌	상징, 상징 기호
심벌리즘	상징주의
심벌마크	상징 표시, 상징 표지, 상징표
심포니	교향악
심포니 오케스트라	교향악단
심포지엄	학술 토론회, 학술 토론 회의, 집단 토론 회의
싱글 매치	일대일 경기
싱글 윈도 시스템	통관 단일 창구제
싱크 탱크	두뇌 집단, 참모 집단
싱크홀	땅꺼짐, 꺼진 구멍, 함몰 구멍
싱킹 현상	함몰, 함몰 현상, 꺼짐, 꺼짐 현상
아듀	안녕
아로마 다이어트	향기 건강법
아로마 세러피	향기 요법
아르 누보	신예술
아미 룩	군복풍, 육군복풍
아바타	분신, 가상 인물
아방가르드	전위, 선구자
아우라	기품
아웃 웨어	야외복
아웃 포커싱	배경 흐리기
아웃라이어	독특한 사례
아웃리치	현장 봉사, 현장 지원 활동
아웃바운드	전화 방문 영업, 외국행, 해외여행
아웃소싱	외주, 위탁, 외부 용역, 외부 위탁, 외부 조달
아웃풋	출력
아이덴티티	상표 정체성, 상표 일체감, 상표 이미지, 통합 상표 이미지, 브랜드 이미지
아이스 브레이킹	어색함 풀기, 서먹함 깨기, 서먹함 풀기
아카이브	자료 보관소, 자료 저장소, 기록 보관소, 기록 보관
아카이빙	자료 보관, 자료 전산화, 기록 보관, 자료 저장
아케이드	연쇄 상가, 연립 상가
아키텍처	건축, 설계, 설계 구조, 시스템 구성
아트 마켓	예술 시장
아트 페스티벌	예술 축전, 예술 축제
아트 페어	미술 전람회
아틀리에	작업실, 제작실
아티스틱 디렉터	예술 감독
안테나 숍	전략 점포, 시장 조사 점포
안티사이트	반대 사이트
안티에이징	노화 방지
알고리즘	셈법, 연산 방식, 풀이 흐름
알비노	백색증, 백화 개체
암홀	진동
앙상블	합주단, 조화
앙케트	설문 조사
애널리스트	분석가, 증시 분석가
애니멀 호더	동물 수집꾼
애니메이터	만화 영화가
애드벌룬	광고 풍선, 광고 기구
애버리지	평균
애시 그레이	잿빛, 회색
애시 블루	회청색
애프터 마켓	후속 시장
애플리케이션 프로그램	응용 프로그램
액세스	접근, 접속
액셀러레이터	새싹 기업 육성 기관, 창업 초기 기업 육성 기관, 창업 기획자
액셀러레이팅	육성, 창업 기획
액션 미팅	활성화 모임
액션 페인팅	행위 그림, 행위 예술
액션 플랜	실행 계획, 세부 계획
액자 프레임	그림틀
액티브 에이징	활기찬 노년
액티비티	활동
앤티크	고풍
앰부시 마케팅	간접 판촉
앰비슈머	가치 소비자
앰프	확성기, 확성 장치
앵커 기업	선도 기업, 중심 기업
앵커 숍	거점 매장
앵커 시설	종합 지원 시설
어닝 서프라이즈	실적 급등, 실적발 주가 상승, 호실적 주가 상승, 깜짝 실적
어닝 쇼크	실적 충격, 실적발 주가 하락, 악실적 주가 하락
어덜트	성인, 성인 시장
어드바이스	도움말, 조언, 충고
어반 라이프	도시 생활
어반 아트리움	문화 상업 가로, 도시 문화 상업 가로
어뷰징	① 조회 수 조작 ② 부정 행위 ③ 남용 ④ 도배질, 베끼기
어시스턴트	① 부심 ② 보조원, 보조
어워드	상, 시상식
어젠다	의제, 가치관
어트랙션	구경거리, 명소, 놀이 기구
어패럴	의복, 의류
어패럴 메이커	의복 제조업, 의류 업체
언더그라운드	장외, 지하
언더독	약자, 약자 효과
언더라인	밑줄
언더스터디	대기 배우
언더패스	아래 차로
언로더	짐부림틀
언론 플레이	여론 몰이
언박싱	개봉, 개봉기
언택트	비대면
언터처블	손댈 수 없는, 대단한
얼라이언스	동맹, 연합체, 동맹 단체, 연합
얼리 버드	조기 할인, 앞선 구매자
얼리 어답터	앞선 사용자
얼터너티브	대안
엄파이어	심판
업 스타일	올린머리
업로딩	올리기, 게시
업사이클	새 활용
업스트림	위 흐름, 위 단계 흐름, 윗단계 흐름
에너지 바우처	에너지 상품권, 에너지 사용권
에듀 컬처 콘텐츠	교육 문화 콘텐츠
에듀테인먼트	놀이식 교육, 놀이 학습
에듀테크	교육 기술
에디션	한정품, 한정판
에디터	편집자, 편집기
에디트	편집
에볼루션	진화
에스닉	민속복, 민속풍, 민족 전통의
에어 서큘레이터	공기 순환기
에어 워셔	공기 세척기, 공기 세정기
에어 캡	뽁뽁이
에어 커튼	공기 커튼, 공기 조절, 공기 조절 장치
에어 클리너	공기 거르개, 공기 청정기
에어 택시	비행 택시, 항공 택시
에어컨디셔너	냉난방기, 공기 조절기
에이전시	대행사
에이전트	대리점, 대리상, 대리인, 대행인
에이징	건식 숙성
에지 컴퓨팅	분산 서버 실행, 실시간 데이터 처리
에코 드라이빙	친환경 운전
에코 디자인	친환경 디자인
에코 마일리지	환경 적립금, 친환경 적립금
에코 힐링	자연 치유
에필로그	끝말, 후기, 맺음말, 맺음 영상
엑소더스	탈출, 대이동
엑스포	미용 국제 박람회
엔드 라인	끝줄, 뒷줄
엔딩 크레디트	끝자막, 맺음자막
엔지니어링	공학, 기술 개발
엔트리	참가자 명단, 선수 명단, 출전 선수 명단
엠바고	① 보도 유예 ② 금수 조치
엠블럼	상징, 상징표
옐로 카펫	건널목 안전 구역, 어린이 횡단보도 대기소
오가노이드	장기 유사체, 유사 장기
오가닉	유기농, 유기체
오너 리스크	경영주발 악재, 기업주 위험, 독단 경영 위험
오너드라이버	손수 운전자
오디언스	시청자, 청취자, 청중, 관객
오디오 가이드	음성 안내, 음성 안내기
오리엔탈 드레스	동양풍 드레스, 동양풍 옷
오리엔탈 스타일	동양풍
오리엔탈리즘	동양주의
오마주	헌정 인용
오버 페이스	무리
오버독	강자
오버랩	겹침
오버랩핑	겹치기, 중복
오버로드	과부하
오버부킹	초과 예약
오버슈즈	덧신발
오버웨이트	과다 보유, 중량 초과, 비중 확대
오버코트	외투
오버행	물량 부담
오버홀	재생 수리, 완전 분해 수리
오브제	물체, 물건, 대상
오브젝트	목적, 객체, 사물, 물건
오서독스	전통적, 정통적
오션 뷰	바다 전망
오일 쇼크	석유 파동
오일볼	기름 뭉치
오일펜스	기름 막이, 기름 차단막
오일허브	석유 집산지
오토 레이스	자동차 경주
오토 프로그램	자동 프로그램
오토캐드	자동 설계, 자동 전산 설계
오토캠핑	자동차 야영
오트 쿠튀르	고급 의상점, 고급 의상, 고급 맞춤복, 고급 의상 박람회, 고급 맞춤복 박람회
오퍼레이터	운영자
오퍼상	판매 알선업자, 판매 확약업자
오프 더 레코드	비보도, 비보도 기자 회견
오프 시즌	비경기철
오프너	병따개, 따개
오프숄더	맨어깨
오픈 뱅킹	공동망 금융 거래, 은행 통합 거래
오픈 뱅킹 플랫폼	공동망 금융 거래 체계, 은행 통합 거래 체계
오픈 베타	공개 시험
오픈 소스	무료 자원, 자원 개방, 공개 자료
오픈 스카이	항공 자유화
오픈 이노베이션	개방형 혁신, 개방형 혁신 전략
오픈 캠퍼스	기관-대학 협력 교육, 공개 교실
오픈 키친	개방형 주방
오픈 프라이머리	국민 경선, 국민 경선제
오픈 플랫폼	개방형 작업 공간
오피니언 리더	여론 주도자, 여론 주도층
온 디맨드	주문형
올 오버 페인팅	균질 그림
옴니버스	모음, 모음집
옴니채널	통합 유통망
옴부즈맨	민원 도우미
옵서버	원양 어선 감시 관찰자
옵아트	광학 미술
옵티컬 일루전	착시
와레즈 사이트	불법 소프트웨어 사이트
와이어 브러시	쇠솔
왜건	유아 수레, 수레
왝 더 독	본말 전도
외교파우치	외교 행낭
울트라미니	초미니
워 게임	군사 연습 모의 전쟁
워드 마크	글자 상징
워라밸	일삶균형, 일과 삶의 균형
워셔블	물세탁 가능, 물세척 가능
워셔블 슈트	물빨래 옷, 물빨래 양복
워커홀릭	일 중독자, 일벌레
워크 아웃	기업 회생 작업, 기업 개선 작업, 신용 회복
워크북	익힘책
워크셰어링	일자리 나누기
워키토키	휴대용 무전기
워킹 그룹	실무단, 실무 협의단
워킹 대디	일하는 아빠, 직장인 아빠
워킹 슈즈	산책화
워킹 투어	걷기 여행
워킹 푸어	근로 빈곤층
워킹 홀리데이	관광 취업
워터 스크린	수막 영상
워터 프런트	수변, 물가
워터마크	식별 무늬, 복제 방지 무늬
워터마킹	식별 무늬, 복제 방지 무늬
원 스트라이크 아웃	즉시 퇴출, 즉시 퇴출제
원 클릭	한 번 접속, 일 회 접속, 단건, 단번 처리
원 포인트	단건 집중, 단건, 요점, 한 곳
원데이 클래스	일일 강좌
원샷 플레이	마지막 공격
원스톱	일괄, 통합, 한자리
웜업	예열
웨어러블	착용 가능
웨어러블 스마트 디바이스	착용하는 스마트 기기, 착용 가능 스마트 기기
웨이트 트레이닝	근력 훈련, 근력 강화 훈련
웨이팅	기다림, 대기
웨이팅 서클	타자 대기석
웨이팅 타임	기다림 시간, 대기 시간
웨이퍼	회로판
웨트 에이징	습식 숙성
웰니스	건강 관리
웰메이드 플레이	잘 꾸며진 극
웹진	누리 잡지, 인터넷 소식지
위그선	수면 비행 선박
위너	승자
위크	황금 주간
위트	재치, 기지
윈드 시어	급변풍, 돌풍
윈드 재킷	바람막이, 바람막이 옷
윈드브레이커	바람막이 옷
유니버설 디자인	범용 디자인
유니섹스	남녀 겸용
유니콘 기업	거대 신생 기업
유저	다회용 컵
유저 인터페이스	사용자 환경
유커	중국 관광객, 중국인 관광객
유턴 기업	귀환 기업, 선회 기업
의료 텔레메트리	화상 처치 체제, 원격 화상 처치 체제
이 러닝	인터넷 학습, 온라인 학습
이 북	전자책
이 커머스	전자 상거래
이그조틱	이국풍
이너 서클	핵심층, 패거리
이노베이션	개방형 혁신, 개방형 혁신 전략
이노베이션 랩	기술 혁신 연구소
이노베이터	혁신자
이노비즈	혁신형 중소기업
이니셔티브	주도권, 구상, 발의
이머징 마켓	신흥 시장
이메일 리스트	전자 우편 주소 목록
이메일 마케팅	전자 우편 판촉
이미테이션	모조, 모방, 흉내
이스터 에그	숨은 뜻, 숨은 재미, 숨은 메시지, 숨은 기능
이스트	작명가, 이름 설계사
익스트림 스포츠	극한 스포츠
인덱스 펀드	지수 연동형 기금
인도어 링크	실내 스케이트장
인도어 테니스	실내 테니스
인디 영화	독립 영화, 저예산 독립 영화
인디케이터	지시기, 지시계
인력 풀	인력 자원, 인력 은행, 후보군
인바운드	국내
인벤토리	목록
인보이스	송장, 보냄표
인스톨	설치
인스트럭터	강사, 지도자, 강습자
인스피레이션	영감
인저리	부상
인저리 타임	추가 시간
인큐베이팅	창업 보육, 육성, 보육
인큐베이팅 펀드	창업 보육 자금
인터내셔널	국제, 국제적
인터랙션	상호 작용
인터랙티브	쌍방향, 양방향, 대화형
인터벌	휴식 시간, 간격
인터셉트	가로채기
인터체인지	나들목
인턴십	실습 사원제, 실습 사원 제도, 직무 실습
인텔리	지식인, 지식층
인트라넷	내부 전산망
인포 이미징	영상 정보
인포그래픽	정보 그림
인포메이션	정보, 안내
인포테인먼트	정보 오락 프로그램
인풋	입력
인프라	친환경 기반 시설, 녹색 기반 시설
인프라 펀드	기반 시설 기금
인플레이션	물가 오름세
인플렉션	억양, 어조
인플루언서	영향력자
인하우스	계열사, 조직 내부의
일러스트	삽화, 도안
일렉트로닉 뱅킹	전자 금융
임베디드	내장형
입시 컨설팅	입시 상담
잇 아이템	매력 상품
잡 네트워킹	일 연계망, 일 연계망 형성, 일자리 연계망, 일자리 연계망 형성
잡 매칭	일자리 연결
잡 서치	직업 탐색
잡 카페	취업 카페, 취업 상담소
잡 페스티벌	일자리 한마당, 취업 박람회
저널	언론, 학술지, 시보
저널리스트	언론인
저널리즘	언론, 언론 문화, 언론 사업
전자 바우처	전자 이용권
정크 아트	폐물 예술, 폐품 예술, 쓰레기 미술
정크 푸드	부실 음식, 부실 식품
제너레이터	발전기
제네릭	복제약
제로 데이	취약점 선제 공격
제로 레이팅	사용료 우대 정책
제로 베이스	백지 상태, 원점
제로 에너지	에너지 자급, 에너지 자급 자족, 에너지 절감
제로 이코노미	성장 멈춤 경제
제로섬	합계 영
제로섬 게임	실익 없는 짓, 실익 없는 경쟁
제로화	없애기, 줄이기, 예방
젠더	성, 성 인지, 성평등, 성별
젠트리피케이션	둥지 내몰림, 원주민 내몰림
조인트	합동, 연합
조인트 벤처	합작 투자
조크	농담, 우스개
주니어 보드	청년 중역 회의
지소미아	군사 정보 보호 협정, 한일 군사 정보 보호 협정
차이니즈 칼라	중국깃, 중국옷깃
차일드 웨어	아동복
찬스 메이커	득점 조력자
찬스 메이킹	기회 만들기
챌린저	도전자
챕터	분야, 장
챗봇	채팅 로봇
체인 스토어	연쇄점
체인지 메이커	혁신가
치어 리딩	응원
치킨 게임	끝장 승부
카 셰어링	자동차 공유, 자동차 공유 서비스
카고	짐, 화물
카고 십	짐배, 화물선
카드 론	카드 대출
카드 리더	카드 판독기
카디즈	한국 방공 식별 구역
카라반	① 캠핑카, 이동식 주택 ② 투자 현장 방문단
카르텔	담합, 범죄 조직
카메라 워크	촬영 기법
카메오	깜짝출연, 깜짝출연자
카운슬러	상담자, 교도 교사
카운슬링	상담
카운터블로	받아치기
카운터파트	상대방
카운터펀치	받아치기, 반격, 역습
카이스트	한국과학기술원
카타르시스	정화
카피라이터	광고 작가, 광고 문안가
카피라이트	저작권
칼럼니스트	시사 평론가, 특별 기고가
캐노피	덮지붕
캐드	자동 설계, 자동 전산 설계
캐디	경기 보조원
캐리커처	풍자화
캐릭터 브랜드	개성 상표, 특성 상표
캐비테이션	공동 현상
캐셔	계산원, 수납원
캐스트	배역
캐스팅 디렉터	배역 감독
캐스팅 보트	결정권, 결정표
캐시 카드	현금 카드
캐시 카우	돈줄, 금고
캐시 플로	현금 흐름
캐처	포수
캐치	잡기, 공 잡기
캐치 업	따라 잡기
캐치프레이즈	구호, 선전 구호
캐포츠	활동 기능복
캐피털	벤처 투자사, 벤처 기업 자본, 벤처 투자 자본
캘리그래피	멋 글씨, 멋 글씨 예술
캠퍼스 리크루팅	교내 채용 설명회
캠퍼스 타운	대학촌, 대학 거점 도시
캠페스트	야영 축제
캡션	설명, 짧은 설명문
캡스톤 디자인	창의적 종합 설계
커넥션	결탁, 연계, 야합
커넥터	접속기
커넥티드	연결, 통신 연결
커넥티드 시티	통신 연결 도시
커넥티드 카	통신 연결 차량
커넥티비티	통신 연결성
커리어	경기 경력
커리어 우먼	전문직 여성
커리큘럼	교과 과정, 교육 과정
커머스	전자 상거래
커뮤니티 맵	참여형 지도 제작
커뮤니티 시어터	지역 연극
커뮤니티 케어	지역 사회 돌봄, 지역 사회 통합 돌봄, 더불어 돌봄, 공동체 돌봄
커미션	수수료, 구전
커버리지	범위, 맡은 범위, 대역, 수신 가능 지역
커버스토리	표지 기사
커스터마이즈	맞춤
커스터마이징	맞춤, 맞춤 제작, 맞춤 상품, 맞춤 디자인
커터기	자르개
커튼콜	부름갈채
커플러	연결기
컨버전	전환, 변환, 개조
컨버터	이중 변환기, 이중 역병렬 변환기
컨버팅	변환
컨베이어	운반, 운반기
컨베이어 벨트	자동 운반대
컨벤션	대회, 전시, 행사
컨벤션 뷰로	회의 사무국, 국제회의 전담 조직, 국제회의 사무국, 국제회의 지원 조직
컨벤션 효과	행사 효과
컨설턴트	상담사
컨설팅	결혼식 상담 업체, 결혼식 상담 회사
컨소시엄	협력체, 연합체, 협력 모임
컨트롤 보드	조정판
컨트롤 타워	지휘 본부, 사령탑, 통제탑
컨트롤러	조정기, 제어 장치
컨트리 리스크	국가별 위험도
컨트리클럽	골프장
컨트리풍	시골풍, 전원풍
컨티넨탈 챔피언십	대륙 간 선수권 대회
컨틴전시 플랜	비상 계획
컨플릭트	갈등, 이해 충돌, 이익 충돌
컬덕트	문화 융합 상품
컬러 매치	색 배합
컬러 푸드	색깔 먹거리, 색깔 식품
컬러 필터	색 필터, 착색 필터
컬러리스트	색채 전문가
컬렉션	수집품, 발표회, 의상 발표회
컬트	소수 취향
컴퓨팅	컴퓨터 연계 활용
컴프레서	압축기, 압착기, 강우기
컴필레이션	선집, 모음집
컵 홀더	컵걸이
컷오프	탈락, 공천 배제, 예비 경선
케미컬	화학, 화학 합성
케어 플랜	돌봄 계획, 복지 계획, 간호 복지 계획
케이스 스터디	사례 연구
케이크 커팅	자르기, 케이크 자르기
케이터링	출장 음식, 출장 연회
코덱스	국제 식품 규격, 국제식품규격위원회
코드 셰어	공동 운항
코드 인사	편향 인사, 성향 인사
코디네이션	① 조화, 배합 ② 의상 연출
코마	대칭복사
코멘테이터	해설자
코믹 터치	익살풍, 희극적 기법
코스메틱	화장품
코스튬 주얼리	패션 모조 보석
코스튬 플레이	의상 연출, 의상 연기
코스프레	① 행세 ② 분장 놀이
코워킹	협업, 공동 작업
코워킹 스페이스	협업 공간
코즈모폴리턴	세계주의자
코칭	맞춤 지도
코튼	면, 면직물, 목화, 솜
콘덴서	축전기, 축전지
콘솔	조종대
콘솔 박스	정리함
콘시어지	총괄 안내, 총괄 안내인
콘택트 포인트	연락처, 연락 창구
콘텍스트	맥락, 문맥
콘트라스트	대비
콘퍼런스	대규모 회의, 학술회의, 학술 대회
콘퍼런스 콜	화상, 통신 회의, 전화 회의
콜드 체인	저온 유통, 냉장 운반 보관
콤비 플레이	호흡 맞추기
콤비네이션	조합, 짝, 호흡 맞추기
콤팩트	압축, 간편
쿨다운	냉각
쿨링 포그	안개형 냉각, 안개형 냉각수, 안개 분사기
쿨링오프	계약 철회 보증, 계약 철회 보증 제도
쿼터	한도량, 배당량, 할당
쿼터 파이널	준준결승
쿼터제	할당제, 의무 할당제, 의무 배당제
큐레이션	추천, 정보 추천
큐레이션 서비스	추천 서비스, 정보 추천 서비스
큐레이터	전시 기획자, 학예사
큐비즘	입체파, 입체주의
크라우드 펀딩	대중 투자
크라우드소싱	대중 참여 제작, 대중 참여 생산
크라이시스	위기
크래시 헬멧	안전모
크래프트 맥주	수제 맥주
크랙	균열, 갈라짐
크랭크 인	촬영 시작, 촬영 개시
크레디트 라인	신용 한도
크레디트 카드	신용 카드
크레디트 타이틀	소개 자막, 영화 소개 자막
크레바스	빙하 균열, 빙하 틈, 공백, 틈
크로스 라이선스	특허 교환, 특허 교환권
크로스 핏	고강도 복합 운동
크로스오버	교차 융합, 융합, 넘나들기
크로스컨트리	지구력 경기, 산야 경기
크리에이터	지역 가치 창출가, 지역 가치 창업가, 지역 창업가
크리에이티브	창조적, 독창적
클라우드	자원 공유, 인터넷 기반 자원 공유
클라우드 서비스	인터넷 자원 공유 서비스, 인터넷 기반 자원 공유 서비스
클래시시즘	신고전주의
클래식 스타일	고전 양식, 고전적 양식
클랙슨	경음기, 경적
클러스터	생명 공학 협력 단지
클럽 하우스	골프장 본관
클레임	손해 배상 청구, 이의 제기
클로버	토끼풀
클로징	마무리, 맺음
클로징 멘트	맺음말
클리닝 타임	정리 시간
클리어런스 세일	재고 할인, 재고 할인 판매, 떨이 판매
클리핑	추림, 뽑아냄, 오려 모음
클린 디젤	저공해 디젤
클린 룸	청정실
클린 서포터스	청렴 홍보단
클린 에너지	청정 에너지
클린 이팅	자연식
클린 존	안전 지역, 청정 지역, 선도 지역, 선도 대상 지역, 모범 지역
클린도	청정도
키 맨	중추 인물, 핵심 인물
키 플레이어	핵심 인물, 핵심 인사, 핵심 선수
키네틱 아트	동작 예술, 동적 예술
키오스크	무인 안내기, 무인 단말기, 무인 주문기, 간이 판매대, 간이 매장
키트	구호 도구, 구호 도구 모음, 구호 도구 꾸러미, 구호 상자
키패드	자판, 숫자 판
킥오프 회의	첫 회의, 첫 기획 회의
킬러 콘텐츠	돌풍 콘텐츠, 핵심 콘텐츠
타깃 마케팅	주요 판촉, 중점 판촉
타깃 하드닝	방범 시설 강화
타운 웨어	외출복, 나들이옷
타운 홀 미팅	주민 회의, 구성원 회의, 주민 참여 공개 회의
타이 브레이크	동점 끝내기
타이트	빡빡한, 팽팽한
타이틀 매치	선수권전
타이틀리스트	선수권자, 타이틀 보유자
타이틀전	선수권전
타이프 문서	타자 문서
타이피스트	타자원
타임 레이스	기록 경기
타임 슬립	시간 여행
타임 오프제	근로 시간 면제 제도, 근무 시간 인정 제도
타임 테이블	시간표
타임래그	시차
타투	문신
타투이스트	문신사
태그	생명 팔찌
태스크	작업
태스크 포스	전담반, 전담 조직, 특별 전담 조직, 특별팀, 전담팀
탱크로리	용기 적재차
터닝 포인트	전환점
터치라인	옆줄
터치라인 아웃	옆줄 나감, 옆줄 밖나감
터치스크린 패널	접촉 화면 판
턴 오버	① 총매출 ② 회전율 ③ 실책
턴키	일괄, 한목, 일괄 발주
테넌트	핵심 점포
테니스 엘보	팔꿈치 통증
테니스 웨어	테니스복
테라피	향기 요법
테마 브리핑	주제 보고
테마주	화제주
테스터	체험 평가자
테스트 마켓	시험 시장
테스트 베드	가늠터, 시험대, 성능 시험장
테스트 스크리닝	미리 보기
테스트 이벤트	시험 경기, 시험 행사
테이블 매너	식사 예절
테이저건	전기 충격총
테이크 오프	이륙
테이퍼링	양적 완화 축소
테이프 커팅	줄 자르기, 색줄 자르기
테크	국제 금융 기술
테크노폴리스	첨단 산업 연구 도시
테크놀로지	과학 기술
테크니션	기교파, 기술자
테크핀	금융 기술, 기술 기반 금융
테트라포드	네발 방파석, 파도막이 돌
텍스처	질감, 재질감
텍스타일	직물, 섬유, 실
텍스트	연결 문서
텔레마케팅	전화 판매, 통신 판매
텔레매틱스	원격 서비스, 차량 무선 인터넷 서비스, 차량 내 무선 인터넷
템플 스테이	절 체험, 사찰 체험
토털 서비스	종합 서비스
토털 솔루션	종합 해결책
토털 시스템	종합 체계
토털 패션	종합 패션, 모듬 맵시
톱 브랜드	유명 상표
톱기사	머리기사
톱다운	하향식
투 톱	두 주공격수, 쌍두, 2인, 두 사령탑
투 트랙	양면, 두 갈래, 이원화
투어 코스	여행길, 관광 코스
투어 콘서트	순회 공연
투어리즘	친환경 관광
투웨이	이원적
툴바	도구 막대
툴키트	연장 모음, 도구 모음
튜닝 차	개조 차
튜터리얼	지침, 지침서
튜토리얼 세션	특강 시간, 분야별 발표
트라이아웃	실력 점검, 공개 선발 시험
트래디셔널 룩	전통풍
트래블러	여행자
트래이딩 플로어	거래장, 매매장
트래킹	도보 여행, 걷기
트래픽	소통량, 교통, 통화량
트래핑	사다리 놓기, 공 다루기
트랙	구경거리, 명소, 놀이 기구
트랙 레코드	기록, 실적, 경력
트랜스	변압기
트랜스미디어	매체 융합
트램	전차, 노면 전차
트랩	위장 폭탄
트레이	단타 매매, 초단타 매매
트레이 페이퍼	쟁반 종이, 쟁반 깔지
트레이드	지역형 공정 무역
트레이드 머니	이적료
트레일	예고편
트렌드 컬러	유행색, 경향색, 패션 경향색
트렌드세터	유행 선도자
트로이카	삼두마차, 삼두 체제, 삼인방
트로피컬 룩	열대풍
트리 포트	화분
트리거	방아쇠
트리거 광고	유인 광고
트리밍	바로 재생, 실시간 재생
트릭 아트	착시 예술, 착시 그림, 눈속임 예술, 눈속임 그림
티 테이블	차 탁자
티저 포스터	예고 포스터
티처 보이	교사 의존 학생
티핑 포인트	급변점
틴에이저	청소년, 십대
틸팅 열차	준고속 열차
팀 닥터	전담 의사, 팀 전담 의사, 전속 의사, 팀 전속 의사, 팀 주치의
팀 빌딩	팀 단합, 조직 강화
팀 컬러	팀 색깔, 팀 특징, 팀 성향
파노라마 선루프	전면 지붕창
파라미터	매개 변수
파밍	인터넷 금융 사기
파빌리온	전시관, 가설 건물
파우더 룸	화장방
파우치	외교 행낭
파운드리	조립, 조립 생산, 위탁 생산
파워 게임	권력 다툼, 세력 다툼
파이널 게임	마지막 경기
파이어니어	개척자, 선구자
파이프라인	① 개발 진행 제품 ② 촉매제, 연결관
파이핑 현상	누수, 누수 현상
파인 플레이	멋진 경기, 깨끗한 경기
파일 박스	서류함
파일럿 프로그램	맛보기 프로그램, 시험 프로그램
파트너사	협력사
파트너십 이니셔티브	친선 발의권, 협력 구상
파티 웨어	연회복, 파티복
파티션	칸막이, 가르개, 가르기
판타지 동화	환상 동화
팔레트	갤판, 운반대, 운반함
팔로어	딸림벗
팜 스쿨	농어촌 체험 학교
팝업	알림 창
팝업 북	입체책
팝업 스토어	반짝 매장
팡파르	개막, 개막곡, 축하곡
패널	접촉 화면 판
패닉 룸	피신처
패들링	노질, 노 젓기
패러다임	사고 틀, 구도, 체계
패러독스	역설
패러디	따라 하기, 모방 풍자
패러슈트	낙하산
패밀리 브랜드	통합 상표
패밀리 사이트	관련 누리집
패브릭	직물, 천
패션 디렉터	패션 분석가
패션 비즈니스	패션 사업
패션 사이클	패션 주기, 유행 주기
패션 어드바이저	패션 조언자
패션 컨설턴트	패션 상담사
패션 테마	패션 주제
패스 미스	잘못 주기, 잘못 주다
패스트 트랙	신속 처리제, 신속 처리 안건
패스트 힐링	자투리 휴식
패시브 하우스	초단열 주택, 에너지 절감 주택
패싱	배제, 생략, 따돌림
패치	가죽 조각
패치워크	조각천, 조각천 기법
패키지 디자인	묶음 디자인, 꾸러미 디자인
패키지 딜	일괄 신고, 일괄 타결
패턴 메이커	옷본 제작자
패턴 북	옷본 책, 옷본 서적
패트롤	안전 요원, 순찰
패트롤 카	순찰차
팩션	각색 실화
팩토리	실습장
팬덤	열성 팬, 열성 조직
팬시점	선물 가게
팬터마임	무언극
팰릿	운반대, 운반함
팸 투어	사전 답사 여행, 홍보 여행, 초청 홍보 여행
팸플릿	소책자, 작은 책자
팹리스	반도체 설계 업체, 반도체 설계 전문 기업
퍼내티시즘	열광주의, 광신주의
퍼블리셔	배급사, 게임 배급사
퍼블리시티	광고, 대중성
퍼블리싱	출판, 배급
퍼블릭	일반의, 공공의
퍼블릭 아트	공공 예술
퍼블릭 코스	대중 골프장
퍼센티지	백분율
퍼스낼리티	개성
퍼스널 모빌리티	1인 전동차
퍼스널 컴퓨터	개인용 컴퓨터
퍼스널 트레이닝	맞춤 운동, 일대일 맞춤 운동
퍼스널 파울	접촉 반칙
퍼스트 무버	선도자
퍼실리테이터	조력자, 촉진자, 도우미
펀더멘털	기반, 기초, 기초 여건, 경제 기초 여건, 주요 거시 경제 지표
펀드	국외 증권 포함 기금
펀딩	대중 투자
페넌트 레이스	정규 경기
페널티 에어리어	벌칙 구역
페달링	발판 밟기
페도라	중절모, 중절모자
페디큐어	발톱 화장
페미니스트	여성주의자
페미니즘	여성주의
페스트	야영 축제
페시미스트	비관주의자, 염세주의자
페어	지역형 공정 무역
페이백	환급, 보상 환급
페이소스	정한, 애상, 애수
페이스 메이킹	속도 조절
페이스 페인팅	얼굴 그림
페이저	무선 호출기
페이지 넘버	쪽 번호
페이지 뷰	쪽 보기, 방문자 수
페이징	무선 호출
페이크	이미지 합성 기술, 가짜 영상
페이퍼 컴퍼니	서류상 회사, 유령 회사
페인트 모션	속임 동작
페인트 존	3초 제한 구역
페치카	벽난로
펜네임	필명
펜더	멜빵
펜스	방어, 수비
펜트하우스	하늘채
펠로십	연구 지원금
펫 시터	반려동물 돌봄이
펫 푸드	애완동물 먹이, 반려동물 먹이
포럼	토론회, 대중 토론회, 공개 토론회
포레스트	숲
포맷	양식, 서식, 형식
포멀 드레스	야회복
포멀 웨어	정장
포메이션	정보, 안내
포스트	① 이후, 다음 ② 직위, 부서
포스팅	올리기, 글 올리기
포워더	화물 운송 주선인
포커스	배경 흐리기
포커스 마켓	주요 시장
포커페이스	무표정
포켓 가이드북	휴대용 안내서
포켓치프	주머니 손수건
포크리프트	지게차
포터블	휴대용
포토 데이	사진 홍보
포토저널리스트	사진작가
포트 홀	노면 홈, 바닥 홈, 바닥 패임, 도로 파임
포트폴리오	실적 자료집, 운용 자산 구성, 유가 증권 일람표, 자산 선택, 분산 투자
포퓰리스트	대중주의자, 대중 영합주의자
포퓰리즘	대중주의, 대중 영합주의
폰트	글꼴, 글자체
폴더블 폰	접이식 전화, 접이식 스마트폰
폴딩 도어	접이문
폴리슈머	정책 필요 계층, 복지 소외층
폴리스 라인	통제선
폴리시 믹스	정책 조합
폴리페서	정치 철새 교수
표준 프로세스	표준 과정, 표준 절차
푸드 뱅크	먹거리 나눔터
푸드 스타일리스트	요리 예술사
푸드 스탬프	식품권
푸드 테크	식품 기술
푸드 트립	음식 여행
푸드 플랜	먹거리 순환 종합 계획
푸시 맨	탑승 도움이, 탑승 도우미
푸시 버튼	누름 단추
풀 라인업	전체 구성
풀 빌라	수영장 빌라, 전용 수영장 빌라
풀 스크린	전화면, 전체 화면
풀 스토리	내력, 온내력, 전모, 전체 이야기
풀 시드	전 경기 출전권
풀 시스템	공동 취재
풀 애니메이션	순수 만화 영화
품질 관리 서클	품질 관리반
풋 백 옵션	사후 손실 보전
풋 액션	발 동작
풋워크	발 움직임, 발놀림
퓨처리즘	미래파
프라이	실적 급등, 실적발 주가 상승, 호실적 주가 상승, 깜짝 실적
프라이드	긍지, 자부심
프라이드 에그	달걀 부침, 계란 부침
프라이빗 뱅킹	맞춤 은행
프라이빗 브랜드	자체 상표
프라임 레이트	우대 금리
프라임 시간대	황금 시간대, 주 시청 시간대
프라임 타임	황금 시간
프락치	첩자, 끄나풀
프런티어	개척자
프레스	① 언론, 기자 ② 압박
프레스 디펜스	밀착 방어
프레스 콜	언론 시연회
프레스 투어	기자단 현장 방문
프레싱	전면 강압 수비, 전원 공격 전원 수비
프레임	그림틀
프레임워크	틀, 체계, 체제
프레젠터	발표자
프레젠테이션	발표, 시청각 설명, 시청각 설명회
프레젠트	선물
프레콘서트	사전 공연, 사전 연주회
프로갬블러	도박사, 전문 도박사, 직업 도박사
프로덕션	대량 생산
프로덕트 캐리어	정유 운반선
프로모터	행사 기획자, 행사 기획사
프로세서	응용 프로그램 처리 장치
프로세스	업무 자동화
프로세싱	처리
프로슈머	참여형 소비자
프로텍터	보호대, 보호구
프로토콜	통신 규약
프로토타입	시제품, 원형
프로파간다	선전, 선동
프로파일러	범죄 분석가
프로파일링	범죄 분석
프롤로그	첫 마당, 여는 말, 머리말
프리 로드	기본 탑재
프리 배팅	타격 연습
프리 서버	불법 서버
프리 스로	자유투
프리 존	규제 완화 지역, 규제 대폭 완화 지역, 규제 자유 구역, 규제 청정 지역, 무규제 지역
프리 포트	자유항
프리뷰	시사회, 미리 보기
프리퀄	전사편
프린징	장식술
플라모델	조립 모형, 조립 장난감
플라세보 효과	속임약 효과, 위약 효과
플라스틱 어택	과대 포장 거부 운동, 일회용품 줄이기
플라워 숍	꽃집
플라잉	매달기
플라잉 시스템	매달기 방식
플라잉 카	비행차, 항공 택시, 하늘을 나는 자동차
플라자	광장, 상가
플래그	깃대, 깃발
플래그십	대표 상품, 주력 상품
플래그십 마케팅	대표 상품 마케팅
플래그십 스토어	체험 판매장
플래너	생활 설계사, 보험 모집인
플래드	체크무늬, 바둑판무늬
플래시 몹	번개 공연, 번개 춤사위
플랜테리어	식물 인테리어
플랜트	설비, 시설
플랜트 수출	설비 수출
플랩북	날개책
플랫 슈즈	납작구두
플랫폼	다중 운영 체제
플랫폼 노동	온라인 매개 노동
플랫폼 노동자	온라인 매개 노동자, 온라인 기반 노동자, 온라인 특수 고용 노동자
플러그인	기능 확장 프로그램, 기능 향상 프로그램
플레이 그라운드	운동장
플레이 메이커	주도 선수
플레이팅	담음새
플렉시블	휘는, 유연한
플로깅	쓰담 달리기
플로리스트	화초 전문가
플로어	거래장, 매매장
플로팅 광고	떠돌이 광고
플롯	구성
플리 마켓	벼룩시장
플리 바기닝	자백 감형제, 자백 감형 제도
피싱	문자 금융 사기
피엘 상품	자체 기획 상품
피크	임금 정점제
피크 기간	집중 기간, 절정 기간
피크 타임	한창, 한창때, 절정, 절정기
피킹	가려내기
피팅 룸	탈의실
픽셀	그림낱, 화소
픽션	실화
픽처	큰 그림
픽토그램	그림 문자
핀셋	표적
핀치	위기, 위기 상황
핀테크	국제 금융 기술
핀트	초점
필드	중간 지역
필로티	기둥 방식, 지주 방식
필로티 방식	기둥 방식, 지주 방식
필리버스터	합법적 의사 진행 저지, 무제한 토론
필모그래피	영화 목록, 작품 목록
핑거 페인팅	손가락 그림
핑거 푸드	맨손 음식
하드 트레이닝	맹훈련, 강훈련
하드보일드	냉혹 기법
하우스 웨딩	정원 결혼식
하우스 푸어	내 집 빈곤층
하우스키퍼	객실 담당원
하우스키핑	정리 작업
하우징	겉 상자, 외함
하우징 페어	주택 박람회, 주택 산업 박람회
하이레벨	고급 수준
하이브리드	혼합형, 복합형
하이브리드 카	복합동력차
하이웨이	고속도로
하이킹	소풍, 도보 여행
하이테크	첨단 기술
하이틴	청소년, 십대
하이패션	고급풍, 고급 패션
하이픈	붙임표
핫 머니	단기 투기성 자금, 투기성 단기 자금
핫 스폿	집중 지역, 인기 명소, 고위험 지역
핫 토픽	관심 주제, 인기 화제
핫라인	직통 회선, 직통 전화, 비상 직통 전화
해시태그	핵심어 표시
해커톤	끝장 토론
해피 콜	감사 전화, 확인 전화, 안내 전화
핸드 드립	내림 커피
핸드 브레이크	수동 멈춤 장치, 손 제동 장치
핸드 블렌더	막대형 믹서기, 손방아, 전기 손방아, 맷돌, 전기 맷돌
핸드 시그널	수신호
핸드 프린팅	기념 손찍기
핸드레일	안전 손잡이
행 태그	꼬리표
허들	난관, 장애
허브 공항	중심축 공항
허브 사이트	중심 사이트
허브 항	중심축 항만
헤게모니	주도권
헤드 랜턴	이마 등, 이마 부착형 전등
헤드 헌팅	인력 중개
헤드헌터	취업 관리자, 인재 중개인
헤로인	주인공, 여주인공
헤비 업로더	대량 게재자
헤비 유저	대량 사용자, 다량 사용자, 과다 사용자
헤이트 스피치	혐오 발언, 증오 표현, 혐오 표현
헬프 데스크	도움 창구
혁신 밸리	지능형 농장 혁신 단지
혁신 파크	대학 내 도시첨단산단
호스피스	임종 간호
호이스트	이동용 장치, 승강 장치, 구조 인양기
홀더	컵걸이
홀로그래피	입체 영상
홀로그램	3차원 입체 사진
홈 시어터	안방 극장
홈 헬퍼	가사 도우미, 가정 도우미
홈리스	노숙인, 부랑인
홈베이킹	손수 굽기
홈스쿨링	재택 교육
홈커밍데이	모교 방문일
화이트 리스트	우호 대상, 백색 국가, 수출 절차 우대국, 수출 심사 우대국
화이트 바이오	식물 자원 활용 산업 기술
환 리스크	환차 손실
휘슬	호루라기, 호각
휘핑	거품 크림
휴머노이드	인간형 로봇
휴머노이드 로봇	인간형 로봇
휴머니즘	인본주의
휴머니티	인성, 인간성, 인간애
휴테크	여가 활용 기술, 여가 활용 방법
히든 챔피언	강소 기업, 우량 기업
히트 메이커	인기 제조기, 성공 제조기
AI	① 인공 지능 ② 조류 독감, 조류 인플루엔자
APEC	아시아태평양경제협력체
AR	증강 현실
ASF	아프리카돼지열병
BRT	간선 급행 버스
CES	국제전자제품박람회
EEZ	배타적 경제 수역
EU	유럽 연합
FDA	미국 식품의약국
FTA	유럽자유무역연합
G20	주요 20개국
GDP	국내 총생산
HACCP	식품안전관리 인증기준, 해썹
HUG	주택도시보증공사
ICBM	대륙간 탄도 미사일
ICT	정보 통신 기술
ILO	국제노동기구
IOC	국제올림픽위원회
IP	지식 재산, 지식 재산권
IPTV	인터넷  티브이, 인터넷 텔레비전
IoT	사물 인터넷
KDI	한국개발연구원
LCC	저비용 항공사
LCD	액정 표시 장치, 엘시디
LNG	액화 천연가스
M&A	기업 인수·합병, 인수·합병
MOU	업무 협정, 업무 협약, 양해 각서
NCS	국가직무능력표준
NLL	북방 한계선
OECD	경제협력개발기구, 경협기구
OLED	유기 발광 다이오드, 올레드
P2P	개인 간, 개인 공유
R&D	특허 연계 연구 개발, 지식 재산 기반 연구 개발
RCEP	역내포괄적경제동반자협정
SOC	사회 기반 시설, 사회 간접 자본
SW	소프트웨어
TF	국제자금세탁방지기구
TP	테크노파크
UAE	아랍에미리트
VR	가상 현실
WHO	세계보건기구
WTO	세계무역기구
